###########
## b   b  #
# r       #
##        #
#     b   #
# b       #
##    r   #
#       b #
#    y    #
###########