###########
#      b  #
# b       #
#         #
#     r   #
#         #
#  b      #
#         #
#    y    #
###########