###########
#b   r  #r#
#      ## #
######    #
#       b #
#b  #     #
##### #   #
##    #####
#    y   r#
###########