###########
#r   b  #b#
#      ## #
######    #
#       r #
#b  # #  ##
## ## #   #
##    #b###
#b  #y#   #
###########