###########
#   b     #
# ###r#####
#        r#
#  b      #
#         #
## r    #b#
#     b   #
#    y    #
###########