###########
#       #b#
#b    ### #
####      #
#   rbr   #
#         #
#         #
#         #
#    y    #
###########