  #########
 #     b  #
# r       #
 #        #
#     b   #
# b       #
#    r    #
#         #
#    y    #
###########