###########
##b     b #
####  # ###
##     r  #
#         #
# b       #
##   # #  #
#b        #
#    y    #
###########