###########
## b r b  #
# r       #
##     r  #
#         #
# b       #
##        #
#         #
#    y  b #
###########