###########
# b  r    #
# #       #
###      b#
#  b      #
#  r      #
#    #    #
###      r#
#b  #y#   #
###########